data	자료
soldier	군인
musician	음악가
capital	수도
course	과정
diary	일기
squirrel	다람쥐
dawn	새벽
shadow	그림자
ditch	도랑
crew	승무원
stomach	위
neighbor	이웃 사람
servant	하인
hunger	굶주림
tomb	무덤
taste	맛
sign	신호
stair	계단
trip	여행
brain	뇌
trumpet	나팔
speech	말
thumb	엄지손가락
horn	뿔
chief	우두머리
trousers	바지
prince	왕자
force	힘
sight	광경
space	공간
wool	양모
expressway	고속도로
science	과학
examination	시험
jar	항아리
salt	소금
death	죽음